20 20
2 2 2 3 1 19 1 1 1 1 1 1 1 19 20 20 1 2 1 2
2 18 2 3 1 1 1 19 1 1 1 1 1 19 20 20 1 2 1 2
2 2 2 3 1 1 1 1 1 1 1 1 1 19 19 19 1 2 1 2 
3 2 3 3 1 1 1 5 1 1 19 1 1 1 1 1 1 2 1 2
5 2 4 1 5 2 2 2 4 1 1 1 1 19 1 1 1 2 1 2
19 2 2 19 2 2 19 2 1 1 19 3 1 1 1 1 2 1 2 1
1 4 2 2 2 5 1 2 1 19 3 3 3 1 1 19 1 2 1 2
1 1 5 19 4 1 4 2 2 5 3 16 3 4 1 1 2 1 2 1
1 1 1 19 19 19 1 4 2 2 2 2 2 2 5 1 2 1 2 1
1 1 19 3 3 3 19 1 1 3 3 3 3 2 1 1 2 1 2 1
1 19 3 3 3 3 3 19 1 1 1 1 1 2 1 1 2 1 2 1
19 3 3 3 6 3 3 3 19 1 1 1 1 2 1 1 2 1 2 1
19 3 5 20 2 20 2 2 2 2 2 2 2 2 4 1 2 1 2 1
19 3 3 3 20 3 3 3 19 1 1 1 1 5 19 1 2 1 2 1
1 17 3 3 3 3 3 19 1 1 1 1 1 1 1 1 2 1 2 1
1 1 19 3 3 3 19 1 1 1 19 1 1 1 1 19 2 1 2 1
19 3 5 20 2 20 2 2 2 2 2 2 2 2 4 1 2 1 2 1
19 3 3 3 20 3 3 3 19 1 1 1 1 5 19 1 2 1 2 1
1 17 3 3 3 3 3 19 1 1 1 1 1 1 1 1 2 1 2 1
1 1 19 3 3 3 19 1 1 1 19 1 1 1 1 19 2 1 2 1