20 20 
 2  2  2  3  1  1  1  1  1  1  1  1  3  3  3  3 19 19 20 17 
 2 18  2  4  1  1 19  1 19  1  1  1  3 20 19 19 19  5 20 20 
 2  2  2  3  1  1  1  1  1  1  1  1  3  3  3  3 19 19  4 19 
 4  2  5 19  1  1  1  3  1  1  1  1  1  1  1 19  3 19 19 19 
19  2 19  3  1  1  3  4  3  3  3  1 19  1  1  1 19  3 19  3 
19  2 19  3  1 19  5  2  2  2  2  4  1  1 19  1  1  3 19  3  
 5  2  2  4  3 19  2  2  3  3  2  2  3  1  1  1  1  3  1  3 
 3  4  2  5  4  2  2  5  3 19  3  2  3  1 19  1  1  1  1  1 
19  3  2  2  2  2  4  3  1  1  3  2  3  1 19  1  4  1  1  1 
19  3 19  4  3 19  3 19  1  1  4  2  2  2  2  2  2  5  1  1
 1  1  3  3  1 19  1  1  1  1 19  5  3  3  3  3  2  3  1  1 
 1  1  1  1  1  1  1  1  1  1  1 19  3  3  3 19  2  3  1 19 
 1  19 1 19  3 19  1 19  1  1  1  3  3  3  3 19  2  3  1  1 
 1  1  1  3  3  3  1  1  1  1  3  3 16  3  3  3  2  3  1  1 
 1  19 3  3  6  3  3  3  3  3  3  2  2  2  2 20  2  3  1 19 
 1  3  3 20  2  2  2  2  2  2  2  2  3 19 19  1  5  1  1  1 
 1  19 3  3 20  3  3  3  3  3  3  3  3  1 19  1 19  1  1  1 
 1  1  1  3  3  3  1  1  1  1  1  1  1  1  1  1  1  1  1  1 
 1 19  1 19  3 19  1 19  1  1  1  1 19  1  1  1  1  1  2  2 
 1  1  1  1  1  1  1  1  1  1  1  1  1  1  1  1 19  1  2 20 
